##########################################################
#                                                       G#
#                                                   #####
#                                                        #
#                                                 ##     #
#                                                        #
#                                          H     ##      #
#                                                        #
#        ####                                            #
#                                                        #
#                                      ###      ####     #
#                    ###                                 #
#                                                        #
#                                                        #
#              ###            ####                       #
#                                                        #
#                                         ####           #
#         ##                                             #
#                                                        #
#                                                        #
#   ####                                                 #
#                                ##                      #
#         ##                                             #
#                                                        #
#                                                        #
#             ##                     B                   #
#                                  ####                  #
#          ##                                            #
#                       ###                              #
# P     ####                                             #
##########################################################
