#########################################################
#                                M                     G#
#                           ####                     ####
#                                                       #
#                      ####              M     ####     #
#            M                        ####              #
#       ####              ####              ####        #
#                  M             ##   M                 #
# P        ####         ####        ####         ####   #
#########################################################