###########################################
#                                         #
#P                                        #
##                                        #
#                                         #
#    ##         ##         ##            B#
#                                      ####
#                                         #
#                                         #
#         ###         ###                G#
#                                      ####
###########################################
