####################
#                  #
#     ###          #
#                  #
#  ##        ###   #
#                 G#
####################
