####################
#                  #
#                  #
#                  #
#                  #
# P              G #
####################
