##########################################################
#                                                       G#
#                                                   #####
#                                                        #
#                                                        #
#                                                        #
#                                                        #
#                                                        #
#        ####                                            #
#                                                        #
#                                                        #
#                                                        #
#                                                        #
#                                                        #
#                             ####                       #
#                                                        #
#                                                        #
#                                                        #
#                                                        #
#                                                        #
#   ####                                                 #
#                                                        #
#                                                        #
#                                                        #
#                                                        #
#                                                        #
#                                  ####                  #
#                                                        #
#                       ###                              #
# P     ####                                             #
##########################################################
