


                   G
P     ##    ##   ###
###              ###
###              ###
###              ###
###              ###
###B   O  E     O###
###########################################
