####################
#                  #
# P                #
# ##               #
#                  #
#     ###          #
#                  #
#  ##      ##     G#
####################
